w               w
w   e       w   w
w    w          w
w            w  w
w    w          w
w               w
w   w           w
w            w  w
w               w
w     e         w
w     w         w
w               w
w           n   w
w       w    w  w
w    w          w
w  s            w
w  w      n     w
w               w
w               w
w               w
