    w                   w
    w                   w
    w                   w
    w                   w
    w                   w
    w                   w
    w                   w
    w                   w
    w                   w
    w                  ew
    w                  ww
    w               w   w
    w            w      w
    w        w          w
    w    w              w
    w s       t    w    w
    w  w  n   w   www   w
    wwwwwwwwwwwwwwwwwwwww
