w                            w
w                            w
w                            w
w                            w
w                            w
w              e             w
w          wwwwwwwww         w
w       w            w       w
w     w                w     w
w   w                    w   w
ww            t             ww
w w                        w w
w   w                    w   w
w     w                w     w
w       w            w       w
w         w   s    w         w
w  w        w w w          r w
wwwwwwwwwwwwwwwwwwwwwwwwwwwwww
