        w               w
        w               w
        w               w
        w               w
        w               w
        w               w
        w               w
        w               w
        w               w
        w               w
        w               w
        w               w
        w               w
        w               w
        w        e      w
        w   w    w      w
        w               w
        w      w        w
        w s w         n w
        wwwwwwwwwwwwwwwww
